1111111111111111111
1001000000000000001
1000011111001000001
1P0011E00PC01000001
10010000000C1000001
1111111111111111111