1111111111111111111
1001000000000000001
1000011111001000001
1P1011E100C01000001
10010000001C1100001
1111111111111111111