111111111111111111111111111111
1000E0000000000000000000000011
100000000000000000000000000011
1P0000000000000000000000000011
100000000000000000000000000011
100000000C00000000000000000011
111111111111111111111111111111
