1111111111111
1P000000000C1
1111111111101
100000000C101
1011111110101
101C000C10101
1010111010101
10101E0010101
1010111110101
101C00000C101
1011111111101
1C000000000C1
1111111111111
